ALI = "countries/Alashiya.txt"
ALS = "countries/Alshe.txt"
AMM = "countries/Ammon.txt"
AMU = "countries/Amurru.txt"
ASY = "countries/Assyria.txt"
BAB = "countries/Babylon.txt"
BAG = "countries/Bit Agusi.txt"
BHI = "countries/BitBahiani.txt"
BIA = "countries/BitAdini.txt"
BIT = "countries/Bithynia.txt"
BLE = "countries/Blemmyes.txt"
CRA = "countries/Caria.txt"
DAM = "countries/Aram Damascus.txt"
DIL = "countries/Dilmun.txt"
DMT = "countries/Dmt.txt"
EDO = "countries/Edom.txt"
EGR = "countries/Egrisi.txt"
ELA = "countries/Elam.txt"
GRG = "countries/Gurgum.txt"
HAL = "countries/Halupe.txt"
HAY = "countries/HayasaAzzi.txt"
HDR = "countries/Hadramut.txt"
HIL = "countries/Hilakku.txt"
HIY = "countries/Hiyawa.txt" #Que
HMT = "countries/Hamath.txt"
HNG = "countries/Hanigalbat.txt"
IKK = "countries/Ikkuwaniya.txt"
ISR = "countries/Israel.txt"
JUD = "countries/Judah.txt"
KAS = "countries/Kashka.txt"
KMM = "countries/Kammanu.txt"
KMS = "countries/Karkemish.txt"
KUS = "countries/Kush.txt"
LAN = "countries/Landa.txt"
LAQ = "countries/Laqe.txt"
LYC = "countries/Lycia.txt"
LYD = "countries/Lydia.txt"
MAI = "countries/Main.txt"
MHR = "countries/Mahra.txt"
MIT = "countries/Mittani.txt"
MGN = "countries/Magan.txt"
MOA = "countries/Moab.txt"
MUS = "countries/Mushki.txt"
MYS = "countries/Mysia.txt"
NAS = "countries/Nasibina.txt"
NEN = "countries/Nenassa.txt"
PAM = "countries/Pamphylia.txt"
PHE = "countries/Pheonicia.txt"
PHI = "countries/Philistia.txt"
PNT = "countries/Punt.txt"
PHR = "countries/Phrygia.txt"
PIS = "countries/Pisidia.txt"
PTN = "countries/Pattina.txt"
QED = "countries/Qedarites.txt"
SAB = "countries/Saba.txt"
SUH = "countries/Suhum.txt"
TAB = "countries/Tabal.txt"
THA = "countries/Thamud.txt"
TRO = "countries/Troad.txt"
URA = "countries/Urartu.txt"
ZAM = "countries/Zamani.txt"